^^^^^^^^^^^^^^^^^^^^
^^^^^^^**********^^^
^^^^^*********~~~..^
^^^**********~~~~~..
....***....~~~~~~~~.
..........~~~~~~~~..
......^^...~~~~~~...
.*...^^^^...~~~~....
.**..^^.....~~......
.......^............
