.*......**......*....*...*......*..........**.....
...**.......**........**...*........*...*.........
..*....*................................*....*....
..........~~~~~~~~~~~~~~....~~~~~~................
..*......~~~~~~~~~~~~~~~~~~~~~~~~~~~~~~~~.....*...
........~~~~~~~~~~~~~~~~~~~~~~~~~~~~~~~~~~~.......
.......~~~~~~~~~~~~~..............~~~~~~~~~~......
.*..*.~~~~~~~~~~~~.....*............~~~~~~~.......
.......~~~~~~~~~~~~....*.*......*.*.~~~~~~~~~~....
......~~~~~~~~~~........**...*........~~~~~~~~~~..
..*...~~~~~~~~~~~.....*...........*..~~~~~~~~~~~..
*......~~~~~~~~~~.......**.........~~~~~~~~~~~....
***......~~~~~~~~~~...........*......~~~~~~~~~~~..
**......~~~~~~~~~~......*...........~~~~~~~~~~~...
**.*.....~~~~~~~~~~.....*........~~~~~~~~~~~~~....
*............~~~~~~~~~~..........~~~~~~~~~~~~~~...
.***...........~~~~~~~~~~~~~~~~~~~~~~~~~~~~~~~....
......................~~~~~~~~....................
*.....*....^^^^^^^^....~~~~~~...^^^^^...^^^^^^^...
.............^^^^^^^^..~~~~~...^^^^^^^^^^^^^^^^^..
..*....^^^^^^^^^^^^^^...~~~...^^^^^^^^^^^^^^^^^^..
......^^^^^^^^^^^......~~~~....^^^^^^^^^^^^^^^....
.....^^^^^^^^.........~~~~..^^^^^^^^^^^^^^^^^^^^..
